There are many drops in the ocean...
60
..............WWW...
..............WWW...
..............WWW...
..............WWW...
...............T....
.....W........---...
...iii......--WWW...
...S..........WWW...
...ii.........WWW...
..........1...WWW...
...ii....ii....T....
....W.........---...
............. WWW...
...ii.......--WWW...
..............WWW...
............--WWW...
..............WWW...
.X..A...T......T....
######..###...###...