Pick up all the water drops and reach the exit in time.
40
....................
.................X..
..........##########
....................
WWW....WWWW.........
---....####.........
....................
WWW.................
###.........WWWWW...
............vvvvv...
....WWW.............
....###.............
....................
.1..........W.W.W.W.
####################