Do not touch the flames, and watch how they move.
45
...........................
R.....................X....
..........X.........#######
.......vvvvvv..............
..W..............W.........
####..W.W...W...-----------
.......W...WBW.............
......hhhhhhhh.............
....-...........-...-------
...........................
W..W............W.W.W.W.W.R
####............###########
...........................
.1.........A....WWWWWWW....
#######..IIIIIIIIIIIIIIIIII